000000011000000
000000010000000
000000010000000
000100000000000
000100000000001
000000000000000
000000000100000
000000000100000
111100000010000
100000000010000
100000000000000
000000000000000
000000000000000
000000000000111
000111000000000
000010000000000
000000000000000
000000000011000
000000000011000
000000000011000